"a" = (/turf/space,/area/space)
"b" = (/obj/effect/landmark{name = "Observer-Start"},/turf/space,/area/space)
"c" = (/obj/effect/landmark{name = "JoinLateCryo"},/turf/space,/area/space)
"d" = (/obj/effect/landmark{name = "JoinLateCryoTwo"},/turf/space,/area/space)
"e" = (/obj/machinery/firealarm{dir = 8; pixel_x = -24; pixel_y = 0},/obj/machinery/firealarm{dir = 1; pixel_y = -24},/obj/machinery/firealarm{dir = 4; pixel_x = 24; pixel_y = 0},/obj/machinery/firealarm,/turf/space,/area/space)
"f" = (/obj/item/radio/intercom{dir = 8; pixel_x = 22},/obj/item/radio/intercom{dir = 1; pixel_y = -30},/obj/item/radio/intercom{dir = 4; pixel_x = -22},/obj/item/radio/intercom,/turf/space,/area/space)
"g" = (/obj/effect/wallframe_spawn/reinforced/titanium,/obj/machinery/door/firedoor,/turf/simulated/floor/plating,/area/space)
"h" = (/obj/structure/table/standard,/obj/machinery/light{icon_state = "tube1"; dir = 1},/obj/item/deck/tarot,/obj/machinery/cell_charger,/turf/simulated/floor/tiled,/area/space)
"i" = (/obj/machinery/atmospherics/pipe/simple/hidden{icon_state = "intact"; dir = 6},/turf/simulated/floor/tiled,/area/space)
"j" = (/obj/effect/wallframe_spawn/reinforced/titanium,/obj/machinery/door/firedoor,/obj/machinery/atmospherics/pipe/simple/hidden{icon_state = "intact"; dir = 4},/turf/simulated/floor/plating,/area/space)
"k" = (/obj/machinery/atmospherics/unary/vent_pump/high_volume/external_air{dir = 8; id_tag = "tradeship_shuttle_pump_out_external"},/obj/structure/handrai{icon_state = "handrail"; dir = 4},/turf/simulated/floor/airless,/area/space)
"l" = (/obj/structure/shuttle/engine/propulsion/burst/left{dir = 1},/turf/simulated/floor/airless,/area/space)
"m" = (/turf/simulated/wall/titanium,/area/space)
"n" = (/obj/machinery/atmospherics/unary/vent_pump/on{dir = 2; level = 2},/obj/effect/floor_decal/corner/beige{icon_state = "corner_white"; dir = 10},/obj/machinery/alarm{dir = 4; icon_state = "alarm0"; pixel_x = -24},/turf/simulated/floor/tiled,/area/space)
"o" = (/obj/structure/bed/chair/comfy/brown{dir = 1},/obj/effect/floor_decal/corner/beige{icon_state = "corner_white"; dir = 10},/obj/item/radio/intercom{dir = 8; pixel_x = 22},/obj/machinery/atmospherics/pipe/simple/hidden,/turf/simulated/floor/tiled,/area/space)
"p" = (/obj/structure/shuttle/engine/propulsion/burst/right{dir = 1},/turf/simulated/floor/airless,/area/space)
"q" = (/obj/machinery/door/airlock/hatch,/obj/machinery/atmospherics/pipe/simple/hidden/supply,/obj/machinery/door/firedoor,/turf/simulated/floor/tiled,/area/space)
"r" = (/obj/effect/wallframe_spawn/reinforced/titanium,/obj/machinery/door/firedoor,/obj/machinery/atmospherics/pipe/simple/hidden,/turf/simulated/floor/plating,/area/space)
"s" = (/obj/effect/floor_decal/industrial/outline/yellow,/obj/structure/closet/walllocker/emerglocker/north,/obj/machinery/floodlight,/obj/structure/handrai{icon_state = "handrail"; dir = 4},/turf/simulated/floor/plating,/area/space)
"t" = (/obj/machinery/atmospherics/pipe/simple/hidden/supply,/turf/simulated/floor/tiled,/area/space)
"u" = (/obj/effect/floor_decal/industrial/outline/yellow,/obj/machinery/atmospherics/pipe/simple/hidden{icon_state = "intact"; dir = 5},/turf/simulated/floor/plating,/area/space)
"v" = (/obj/effect/floor_decal/industrial/outline/yellow,/obj/structure/closet/crate,/obj/item/radio,/obj/item/spaceflare,/obj/machinery/firealarm{dir = 4; pixel_x = 24; pixel_y = 0},/obj/machinery/atmospherics/pipe/simple/hidden{dir = 10; icon_state = "intact"},/obj/structure/handrai{icon_state = "handrail"; dir = 8},/turf/simulated/floor/plating,/area/space)
"w" = (/obj/effect/floor_decal/industrial/outline/yellow,/turf/simulated/floor/plating,/area/space)
"x" = (/obj/machinery/atmospherics/pipe/simple/hidden/supply,/obj/machinery/hologram/holopad/longrange,/turf/simulated/floor/tiled,/area/space)
"y" = (/obj/effect/floor_decal/industrial/outline/yellow,/obj/item/storage/backpack/dufflebag,/obj/machinery/atmospherics/pipe/simple/hidden,/turf/simulated/floor/plating,/area/space)
"z" = (/obj/machinery/atmospherics/pipe/simple/hidden/supply{dir = 6},/obj/effect/floor_decal/corner/beige{icon_state = "corner_white"; dir = 9},/obj/item/radio/intercom{dir = 4; pixel_x = -22},/obj/structure/handrai{icon_state = "handrail"; dir = 4},/turf/simulated/floor/tiled,/area/space)
"A" = (/obj/machinery/atmospherics/pipe/manifold/hidden/supply,/obj/machinery/light,/obj/structure/bed/chair{dir = 1},/turf/simulated/floor/tiled,/area/space)
"B" = (/obj/machinery/atmospherics/unary/vent_pump/on{dir = 8; level = 2},/obj/structure/bed/chair{dir = 1},/turf/simulated/floor/tiled,/area/space)
"C" = (/obj/effect/floor_decal/corner/beige{icon_state = "corner_white"; dir = 6},/obj/machinery/alarm{dir = 8; icon_state = "alarm0"; pixel_x = 24},/obj/structure/bed/chair{dir = 1},/obj/machinery/atmospherics/pipe/simple/hidden,/obj/structure/handrai{icon_state = "handrail"; dir = 8},/turf/simulated/floor/tiled,/area/space)
"D" = (/obj/machinery/atmospherics/pipe/simple/hidden/supply,/obj/effect/floor_decal/corner/beige{icon_state = "corner_white"; dir = 9},/obj/structure/handrai{icon_state = "handrail"; dir = 4},/turf/simulated/floor/tiled,/area/space)
"E" = (/obj/machinery/door/airlock/external/bolted{id_tag = "tradeship_shuttle_in"},/obj/structure/cable{icon_state = "4-10"},/obj/machinery/button/access/interior{id_tag = "bearcat_shuttle"; pixel_x = -12; pixel_y = 20},/turf/simulated/floor/plating,/area/space)
"F" = (/obj/machinery/atmospherics/unary/vent_pump/high_volume/external_air{id_tag = "tradeship_shuttle_pump"},/obj/machinery/embedded_controller/radio/airlock/docking_port{cycle_to_external_air = 1; id_tag = "tradeship_shuttle"; pixel_x = 0; pixel_y = -24; tag_airpump = "tradeship_shuttle_pump"; tag_chamber_sensor = "tradeship_shuttle_sensor"; tag_exterior_door = "tradeship_shuttle_out"; tag_interior_door = "tradeship_shuttle_in"},/obj/structure/cable{d1 = 4; d2 = 8; icon_state = "4-8"; pixel_y = 0},/turf/simulated/floor/plating,/area/space)
"G" = (/obj/machinery/airlock_sensor{id_tag = "tradeship_shuttle_sensor"; pixel_y = -24},/obj/structure/cable{d1 = 4; d2 = 8; icon_state = "4-8"; pixel_y = 0},/obj/machinery/atmospherics/unary/vent_pump/high_volume/external_air{dir = 1; id_tag = "tradeship_shuttle_pump_out_internal"},/turf/simulated/floor/plating,/area/space)
"H" = (/obj/machinery/door/airlock/external/bolted{id_tag = "tradeship_shuttle_out"},/obj/machinery/button/access/exterior{id_tag = "tradeship_shuttle"; pixel_x = 18; pixel_y = -20},/obj/structure/cable{d1 = 4; d2 = 8; icon_state = "4-8"; pixel_y = 0},/turf/simulated/floor/plating,/area/space)
"I" = (/obj/machinery/door/airlock/hatch,/obj/machinery/atmospherics/pipe/simple/hidden/supply,/obj/structure/cable{icon_state = "2-5"},/obj/structure/sign{icon_state = "radiation"; pixel_x = 32},/turf/simulated/floor/tiled,/area/space)
"J" = (/obj/machinery/atmospherics/pipe/simple/hidden,/turf/simulated/wall/titanium,/area/space)
"K" = (/obj/machinery/atmospherics/pipe/simple/hidden/supply,/obj/structure/cable{d1 = 1; d2 = 2; icon_state = "1-2"; pixel_y = 0},/obj/structure/handrai{icon_state = "handrail"; dir = 4},/turf/simulated/floor/plating,/area/space)
"L" = (/obj/structure/closet/crate/freezer/rations,/turf/simulated/floor/plating,/area/space)
"M" = (/obj/machinery/portable_atmospherics/canister/air/airlock{start_pressure = 730},/obj/machinery/atmospherics/portables_connector{dir = 1},/turf/simulated/floor/plating,/area/space)
"N" = (/obj/machinery/atmospherics/unary/tank/air,/turf/simulated/floor/plating,/area/space)
"O" = (/obj/machinery/power/apc{dir = 8},/obj/structure/cable{icon_state = "0-4"; d2 = 4},/obj/structure/cable,/obj/machinery/atmospherics/pipe/simple/hidden/supply{dir = 5},/obj/structure/handrai{icon_state = "handrail"; dir = 4},/turf/simulated/floor/plating,/area/space)
"P" = (/obj/structure/cable{d1 = 4; d2 = 8; icon_state = "4-8"; pixel_y = 0},/obj/machinery/atmospherics/pipe/manifold/hidden/supply{dir = 1},/obj/item/wrench,/turf/simulated/floor/plating,/area/space)
"Q" = (/obj/machinery/atmospherics/pipe/simple/visible/universal{dir = 4},/obj/structure/cable{icon_state = "2-8"},/turf/simulated/floor/plating,/area/space)
"R" = (/obj/machinery/alarm{dir = 8; icon_state = "alarm0"; pixel_x = 24},/obj/machinery/atmospherics/pipe/simple/hidden/blue{icon_state = "intact"; dir = 9},/obj/machinery/floodlight,/turf/simulated/floor/plating,/area/space)
"S" = (/obj/machinery/light{dir = 8},/obj/structure/closet/crate/uranium,/obj/machinery/atmospherics/unary/vent_pump/on{dir = 1; level = 2},/turf/simulated/floor/plating,/area/space)
"T" = (/obj/structure/cable,/obj/machinery/power/port_gen/pacman/super,/turf/simulated/floor/plating,/area/space)
"U" = (/obj/structure/shuttle/engine/propulsion/burst/left,/turf/simulated/floor/airless,/area/space)
"V" = (/obj/structure/shuttle/engine/propulsion/burst/right,/turf/simulated/floor/airless,/area/space)

(1,1,1) = {"
aaaaaaaaaaaaaaaaaaaaaaaaaaaaaaaaaaaaaaaaaaaaaaaaaa
aaaaaaaaaaaaaaaaaaaaaaaaaaaaaaaaaaaaaaaaaaaaaaaaaa
aaaaaaaaaaaaaaaaaaaaaaaaaaaaaaaaaaaaaaaaaaaaaaaaaa
aaaaaaaaaaaaaaaaaaaaaaaaaaaaaaaaaaaaaaaaaaaaaaaaaa
aaaaaaaaaaaaaaaaaaaaaaaaaaaaaaaaaaaaaaaaaaaaaaaaaa
aaaaaaaaaaaaaaaaaaaaaaaaaaaaaaaaaaaaaaaaaaaaaaaaaa
aaaaaaaaaaaaaaaaaaaaaaaaaaaaaaaaaaaaaaaaaaaaaaaaaa
aaaaaaaaaaaaaaaaaaaaaaaaaaaaaaaaaaaaaaaaaaaaaaaaaa
aaaaaaaaaaaaaaaaaaaaaaaaaaaaaaaaaaaaaaaaaaaaaaaaaa
aaaaaaaaaaaaaaaaaaaaaaaaaaaaaaaaaaaaaaaaaaaaaaaaaa
aaaaaaaaaaaaaaaaaaaaaaaaaaaaaaaaaaaaaaaaaaaaaaaaaa
aaaaaaaaaaaaaaaaaaaaaaaaaaaaaaaaaaaaaaaaaaaaaaaaaa
aaaaaaaaaaaaaaaaaaaaaaaaaaaaaaaaaaaaaaaaaaaaaaaaaa
aaaaaaaaaaaaaaaaaaaaaaaaaaaaaaaaaaaaaaaaaaaaaaaaaa
aaaaaaaaaaaaaaaaaaaaaaaaaaaaaaaaaaaaaaaaaaaaaaaaaa
aaaaaaaaaaaaaaaaaaaaaaaaaaaaaaaaaaaaaaaaaaaaaaaaaa
aaaaaaaaaaaaaaaaaaaaaaaaaaaaaaaaaaaaaaaaaaaaaaaaaa
aaaaaaaaaaaaaaaaaaaaaaaaaaaaaaaaaaaaaaaaaaaaaaaaaa
aaaaaaaaaaaaaaaaaaaaaaaaaaaaaaaaaaaaaaaaaaaaaaaaaa
aaaaaaaaaaaaaaaaaaaaaaaaaaaaaaaaaaaaaaaaaaaaaaaaaa
aaaaaaaaaaaaaaaaaaaaaaaaaaaaaaaaaaaaaaaaaaaaaaaaaa
aaaaaaaaaaaaaaaaaaaaaaaaaaaaaaaaaaaaaaaaaaaaaaaaaa
aaaaaaaaaaaaaaaaaaaaaaaaaaaaaaaaaaaaaaaaaaaaaaaaaa
aaaaaaaaaaaaaaaaaaaaaaaaaaaaaaaaaaaaaaaaaaaaaaaaaa
aaaaaaaaaaaaaaaaaaaaaaaaaaaaaaaaaaaaaaaaaaaaaaaaaa
aaaaaaaaaaaaaaaaaaaaaaaaaaaaaaaaaaaaaaaaaaaaaaaaaa
aaaaaaaaaaaaaaaaaaaaaaaaaaaaaaaaaaaaaaaaaaaaaaaaaa
aaaaaaaaaaaaaaaaaaaaaaaaaaaaaaaaaaaaaaaaaaaaaaaaaa
aaaaaaaaaaaaaaaaaaaaaaaaaaaaaaaaaaaaaaaaaaaaaaaaaa
aaaaaaaaaaaaaaaaaaaaaaaaaaaaaaaaaaaaaaaaaaaaaaaaaa
aaaaaaaaaaaaaaaaaaaaaaaaaaaaaaaaaaaaaaaaaaaaaaaaaa
aaaaaaaaaaaaaggggaaaaaaaaaaaaaaaaaaaaaaaaaaaaaaaaa
aaaaaaaaaaaaaghijkaaaaaaaaaaaaaaaaaaaaaaaaaaaaaaaa
aaaaaaaaaaaalmnompaaaaaaaaaaaaaaaaaaaaaaaaaaaaaaaa
aaaaaaaaaaaammqrmmaaaaaaaaaaaaaaaaaaaaaaaaaaaaaaaa
aaaaaaaaaaaamstuvmaaaaaaaaaaaaaaaaaaaaaaaaaaaaaaaa
aaaaaaaaaaaagwxwygaaaaaaaaaaaaaaaaaaaaaaaaaaaaaaaa
aaaaaaaaaaaamzABCmaaaaaaaaaaaaaaaaaaaaaaaaaaaaaaaa
aaaaaaaaaaaamDmgrmaaaaaaaaaaaaaaaaaaaaaaaaaaaaaaaa
aaaaaaaaaaaamDEFGHaaaaaaaaaaaaaaaaaaaaaaaaaaaaaaaa
aaaaaaaaaaaamImJmmaaaaaaaaaaaaaaaaaaaaaaaaaaaaaaaa
aaaaaaaaaaaamKLMNmaaaaaaaaaaaaaaaaaaaaaaaaaaaaaaaa
aaaaaaaaaaaamOPQRmaaaaaaaaaaaaaaaaaaaaaaaaaaaaaaaa
aabacadaaaaammSTmmaaaaaaaaaaaaaaaaaaaaaaaaaaaaaaaa
aaeafaaaaaaaUmmmmVaaaaaaaaaaaaaaaaaaaaaaaaaaaaaaaa
aaaaaaaaaaaaaaaaaaaaaaaaaaaaaaaaaaaaaaaaaaaaaaaaaa
aaaaaaaaaaaaaaaaaaaaaaaaaaaaaaaaaaaaaaaaaaaaaaaaaa
aaaaaaaaaaaaaaaaaaaaaaaaaaaaaaaaaaaaaaaaaaaaaaaaaa
aaaaaaaaaaaaaaaaaaaaaaaaaaaaaaaaaaaaaaaaaaaaaaaaaa
aaaaaaaaaaaaaaaaaaaaaaaaaaaaaaaaaaaaaaaaaaaaaaaaaa
"}
