"aa" = (/turf/space,/area/space)
"ab" = (/turf/simulated/wall,/area/constructionsite)
"ac" = (/turf/simulated/floor/tiled,/area/constructionsite)
"ad" = (/obj/machinery/light/spot,/turf/simulated/floor/tiled,/area/constructionsite)
"ae" = (/obj/machinery/light/spot,/turf/simulated/floor/plating,/area/shuttle/escape)
"af" = (/obj/machinery/light/spot{icon_state = "tube_map"; dir = 1},/turf/simulated/floor/tiled,/area/constructionsite)
"ag" = (/obj/effect/landmark/start,/turf/simulated/floor/tiled,/area/constructionsite)
"ah" = (/obj/machinery/power/fusion_core/thermal{anchored = 1},/obj/structure/cable{d2 = 2; icon_state = "0-2"; pixel_y = 0},/turf/simulated/floor/reinforced/airless,/area/constructionsite)
"ai" = (/obj/structure/cable{d1 = 1; d2 = 2; icon_state = "1-2"; pixel_y = 0},/turf/simulated/floor/tiled,/area/constructionsite)
"aj" = (/obj/structure/cable,/obj/machinery/power/debug_items/infinite_generator,/turf/simulated/floor/tiled,/area/constructionsite)
"ak" = (/obj/machinery/light/spot{icon_state = "tube_map"; dir = 8},/turf/simulated/floor/tiled,/area/constructionsite)
"al" = (/obj/effect/landmark{name = "tdome1"},/turf/simulated/floor/tiled,/area/constructionsite)
"am" = (/obj/machinery/atmospherics/pipe/simple/heat_exchanging{icon_state = "intact"; dir = 6},/turf/space,/area/space)
"an" = (/obj/machinery/atmospherics/portables_connector{icon_state = "map_connector"; dir = 8},/obj/machinery/portable_atmospherics/canister/air,/turf/simulated/floor/tiled,/area/constructionsite)
"ao" = (/obj/machinery/atmospherics/pipe/simple/visible{icon_state = "intact"; dir = 4},/turf/simulated/floor/tiled,/area/constructionsite)
"ap" = (/obj/effect/wallframe_spawn/reinforced_borosilicate,/obj/structure/cable{d1 = 1; d2 = 2; icon_state = "1-2"; pixel_y = 0},/turf/simulated/floor/tiled,/area/constructionsite)
"aq" = (/obj/machinery/atmospherics/portables_connector{icon_state = "map_connector"; dir = 8},/obj/machinery/portable_atmospherics/canister/empty,/turf/simulated/floor/tiled,/area/constructionsite)
"ar" = (/obj/machinery/fusion_fuel_injector/mapped{icon_state = "injector0"; dir = 4},/turf/simulated/floor/tiled,/area/constructionsite)
"as" = (/obj/machinery/atmospherics/pipe/simple/visible{icon_state = "intact"; dir = 5},/obj/structure/cable{d1 = 1; d2 = 2; icon_state = "1-2"; pixel_y = 0},/turf/simulated/floor/tiled,/area/constructionsite)
"at" = (/obj/effect/landmark{name = "JoinLate"},/turf/simulated/floor/tiled,/area/constructionsite)
"au" = (/obj/machinery/light_switch/on{pixel_x = -25},/turf/simulated/floor/tiled,/area/constructionsite)
"av" = (/turf/simulated/floor/reinforced/airless,/area/constructionsite)
"aw" = (/obj/effect/floor_decal/industrial/hatch/yellow,/turf/simulated/floor/tiled,/area/constructionsite)
"ax" = (/obj/structure/ladder,/turf/simulated/floor/tiled,/area/constructionsite)
"ay" = (/turf/simulated/wall/iron,/area/shuttle/escape)
"az" = (/obj/effect/wingrille_spawn/reinforced,/turf/simulated/floor/plating,/area/shuttle/escape)
"aA" = (/obj/machinery/computer/shuttle_control{shuttle_tag = "Example"},/turf/simulated/floor/plating,/area/shuttle/escape)
"aB" = (/obj/structure/bed/chair{dir = 1},/obj/machinery/embedded_controller/radio/simple_docking_controller{id_tag = "example_shuttle_starboard"; pixel_x = 28},/obj/machinery/embedded_controller/radio/simple_docking_controller{id_tag = "example_shuttle_port"; pixel_x = -28},/obj/effect/shuttle_landmark/lower_level,/turf/simulated/floor/plating,/area/shuttle/escape)
"aC" = (/obj/machinery/light/spot{icon_state = "tube_map"; dir = 4},/turf/simulated/floor/tiled,/area/constructionsite)
"aD" = (/obj/machinery/door/airlock/external/bolted{id_tag = "example_shuttle_port_hatch"},/turf/simulated/floor/plating,/area/shuttle/escape)
"aE" = (/obj/machinery/door/airlock/external/bolted{id_tag = "example_shuttle_starboard_hatch"},/turf/simulated/floor/plating,/area/shuttle/escape)
"aF" = (/obj/machinery/embedded_controller/radio/simple_docking_controller{id_tag = "lower_level_dock"; pixel_x = -8; pixel_y = -25},/turf/simulated/floor,/area/constructionsite)
"aG" = (/obj/machinery/door/airlock/external/bolted{id_tag = "lower_level_dock_hatch"},/turf/simulated/floor,/area/constructionsite)
"aH" = (/turf/simulated/floor,/area/constructionsite)
"aI" = (/obj/effect/landmark/test/safe_turf,/turf/simulated/floor/tiled,/area/constructionsite)
"aJ" = (/obj/effect/landmark/test/space_turf,/turf/space,/area/space)
"aK" = (/obj/effect/wallframe_spawn/reinforced_borosilicate,/turf/simulated/floor/tiled,/area/constructionsite)
"aL" = (/obj/machinery/atmospherics/pipe/simple/visible{icon_state = "intact"; dir = 6},/obj/structure/cable{d1 = 1; d2 = 2; icon_state = "1-2"; pixel_y = 0},/turf/simulated/floor/tiled,/area/constructionsite)
"aM" = (/obj/structure/table/steel,/obj/machinery/recharger,/turf/simulated/floor/tiled,/area/constructionsite)
"aN" = (/obj/machinery/atmospherics/unary/vent_scrubber/on{icon_state = "map_scrubber_on"; dir = 1},/obj/structure/cable{d1 = 1; d2 = 2; icon_state = "1-2"; pixel_y = 0},/turf/simulated/floor/tiled,/area/constructionsite)
"aO" = (/obj/structure/cable{d2 = 2; icon_state = "0-2"; pixel_y = 0},/obj/machinery/power/apc{dir = 8; name = "west bump"; pixel_x = -24},/obj/structure/cable{icon_state = "2-4"},/turf/simulated/floor/tiled,/area/constructionsite)
"aP" = (/obj/structure/cable{icon_state = "4-8"},/turf/simulated/floor/tiled,/area/constructionsite)
"aQ" = (/obj/structure/table/rack,/obj/item/gun/projectile/automatic/assault_rifle,/obj/item/gun/projectile/automatic/assault_rifle,/obj/item/gun/projectile/automatic/assault_rifle,/turf/simulated/floor/tiled,/area/constructionsite)
"aR" = (/obj/effect/landmark{name = "JoinLate"},/obj/structure/cable{icon_state = "4-8"},/turf/simulated/floor/tiled,/area/constructionsite)
"aS" = (/obj/structure/table/rack,/obj/item/gun/energy/laser,/obj/item/gun/energy/laser,/obj/item/gun/energy/laser,/turf/simulated/floor/tiled,/area/constructionsite)
"aT" = (/obj/structure/cable{icon_state = "1-8"},/turf/simulated/floor/tiled,/area/constructionsite)
"aU" = (/obj/effect/floor_decal/industrial/hatch/yellow,/obj/machinery/fusion_fuel_injector/mapped{icon_state = "injector0"; dir = 4},/turf/simulated/floor/tiled,/area/constructionsite)
"aV" = (/obj/structure/table/rack,/obj/item/gun/projectile/revolver,/obj/item/gun/projectile/revolver,/obj/item/gun/projectile/revolver,/turf/simulated/floor/tiled,/area/constructionsite)
"aW" = (/obj/machinery/computer/fusion/gyrotron,/turf/simulated/floor/tiled,/area/constructionsite)
"aX" = (/obj/structure/table/rack,/obj/item/gun/projectile/shotgun/pump,/obj/item/gun/projectile/shotgun/pump,/obj/item/gun/projectile/shotgun/pump,/turf/simulated/floor/tiled,/area/constructionsite)
"aY" = (/obj/machinery/computer/fusion/core_control,/turf/simulated/floor/tiled,/area/constructionsite)
"aZ" = (/turf/simulated/wall/r_wall,/area/space)
"ba" = (/obj/machinery/computer/fusion/fuel_control,/turf/simulated/floor/tiled,/area/constructionsite)
"bb" = (/obj/machinery/atmospherics/unary/vent_pump/on,/obj/structure/cable{d1 = 1; d2 = 2; icon_state = "1-2"; pixel_y = 0},/obj/machinery/power/emitter/gyrotron/anchored{icon_state = "emitter-off"; dir = 1},/obj/structure/cable{d2 = 2; icon_state = "0-2"; pixel_y = 0},/turf/simulated/floor/tiled,/area/constructionsite)
"bc" = (/obj/machinery/atmospherics/pipe/simple/heat_exchanging{icon_state = "intact"; dir = 4},/turf/space,/area/space)
"bd" = (/obj/machinery/atmospherics/pipe/simple/heat_exchanging{icon_state = "intact"; dir = 10},/turf/space,/area/space)
"be" = (/obj/machinery/atmospherics/pipe/simple/heat_exchanging,/turf/space,/area/space)
"bf" = (/obj/machinery/atmospherics/pipe/simple/heat_exchanging/junction{icon_state = "intact"; dir = 1},/turf/space,/area/space)
"bg" = (/obj/machinery/atmospherics/pipe/simple/visible,/turf/simulated/wall/r_wall,/area/space)
"bh" = (/obj/machinery/atmospherics/pipe/simple/visible{icon_state = "intact"; dir = 6},/turf/simulated/wall/r_wall,/area/space)
"bi" = (/obj/machinery/atmospherics/pipe/simple/visible{icon_state = "intact"; dir = 4},/turf/simulated/wall/r_wall,/area/space)
"bj" = (/obj/machinery/atmospherics/pipe/manifold/visible{icon_state = "map"; dir = 4},/turf/simulated/wall/r_wall,/area/space)
"bk" = (/obj/machinery/atmospherics/pipe/simple/visible,/turf/simulated/wall,/area/constructionsite)
"bl" = (/obj/machinery/atmospherics/pipe/simple/heat_exchanging/junction,/turf/simulated/wall,/area/constructionsite)
"bm" = (/obj/machinery/fusion_fuel_compressor,/turf/simulated/floor/tiled,/area/constructionsite)
"bn" = (/obj/machinery/atmospherics/pipe/simple/visible,/turf/simulated/floor/tiled,/area/constructionsite)
"bo" = (/obj/machinery/atmospherics/pipe/simple/heat_exchanging,/turf/simulated/floor/reinforced/airless,/area/constructionsite)
"bp" = (/obj/effect/floor_decal/industrial/hatch/yellow,/obj/machinery/atmospherics/pipe/simple/visible,/turf/simulated/floor/tiled,/area/constructionsite)
"bq" = (/obj/machinery/atmospherics/pipe/simple/heat_exchanging{icon_state = "intact"; dir = 5},/turf/simulated/floor/reinforced/airless,/area/constructionsite)
"br" = (/obj/structure/cable{d1 = 1; d2 = 2; icon_state = "1-2"; pixel_y = 0},/obj/machinery/atmospherics/pipe/simple/heat_exchanging{icon_state = "intact"; dir = 4},/turf/simulated/floor/reinforced/airless,/area/constructionsite)
"bs" = (/obj/machinery/atmospherics/pipe/simple/heat_exchanging{icon_state = "intact"; dir = 9},/turf/simulated/floor/reinforced/airless,/area/constructionsite)
"bt" = (/obj/item/fuel_assembly/deuterium,/obj/item/fuel_assembly/deuterium,/obj/item/fuel_assembly/deuterium,/obj/item/fuel_assembly/deuterium,/obj/item/fuel_assembly/deuterium,/obj/item/fuel_assembly/deuterium,/obj/item/fuel_assembly/deuterium,/obj/item/fuel_assembly/deuterium,/obj/item/fuel_assembly/deuterium,/obj/item/fuel_assembly/deuterium,/obj/item/fuel_assembly/deuterium,/obj/item/fuel_assembly/deuterium,/obj/item/fuel_assembly/deuterium,/turf/simulated/floor/tiled,/area/constructionsite)
"bu" = (/obj/item/fuel_assembly/tritium,/obj/item/fuel_assembly/tritium,/obj/item/fuel_assembly/tritium,/obj/item/fuel_assembly/tritium,/obj/item/fuel_assembly/tritium,/obj/item/fuel_assembly/tritium,/obj/item/fuel_assembly/tritium,/turf/simulated/floor/tiled,/area/constructionsite)
"bv" = (/obj/machinery/atmospherics/portables_connector{icon_state = "map_connector"; dir = 1},/obj/machinery/portable_atmospherics/canister/phoron,/turf/simulated/floor/tiled,/area/constructionsite)

(1,1,1) = {"
aaaaaaaaaaaaaaaaaaaaaaaaaaaaaaaaaaaaaaaaaaaaaaaaaaaaaaambcbdaaaaaaaaaaaaaaaaaaaaaaaaaaaaaaaaaaaa
aaaaaaaaaaaaaaaaaaaaaaaaaaaaaaaaaaaaaaaaaaaaaaaaaaaaaabeaabeaaaaaaaaaaaaaaaaaaaaaaaaaaaaaaaaaaaa
aaaaaaaaaaaaaaaaaaaaaaaaaaaaaaaaaaaaaaaaaaaaaaaaaaaaaabeaabeaaaaaaaaaaaaaaaaaaaaaaaaaaaaaaaaaaaa
aaaaaaaaaaaaaaaaaaaaaaaaaaaaaaaaaaaaaaaaaaaaaaaaaaaaaabeaabeaaaaaaaaaaaaaaaaaaaaaaaaaaaaaaaaaaaa
aaaaaaaaaaaaaaaaaaaaaaaaaaaaaaaaaaaaaaaaaaaaaaaaaaaaaabeaabeaaaaaaaaaaaaaaaaaaaaaaaaaaaaaaaaaaaa
aaaaaaaaaaaaaaaaaaaaaaaaaaaaaaaaaaaaaaaaaaaaaaaaaaaaaabeaabeaaaaaaaaaaaaaaaaaaaaaaaaaaaaaaaaaaaa
aaaaaaaaaaaaaaaaaaaaaaaaaaaaaaaaaaaaaaaaaaaaaaaaaaaaaabfaabfaaaaaaaaaaaaaaaaaaaaaaaaaaaaaaaaaaaa
aaaaaaaaaaaaaaaaaaaaaaaaaaaaaaaZaZaZaZaZaZaZaZaZaZaZaZbgaZbgaZaZaZaZaaaaaaaaaaaaaaaaaaaaaaaaaaaa
aaaaaaaaaaaaaaaaaaaaaaaaaaaaaaaZaZaZaZaZaZaZaZaZbhbibibjaZbgaZaZaZaZaaaaaaaaaaaaaaaaaaaaaaaaaaaa
aaaaaaaaaaaaaaaaaaaaaaaaaaaaaaaZaZabababababababbkababblabblababaZaZaaaaaaaaaaaaaaaaaaaaaaaaaaaa
aaaaaaaaaaaaaaaaaaaaaaaaaaaaaaaZaZabacacacafacbmbnaraKboavboaKabaZaZaaaaaaaaaaaaaaaaaaaaaaaaaaaa
aaaaaaaaaaaaaaaaaaaaaaaaaaaaaaaZaZabacalalalacawbnaUaKboahboaKabaZaZaaaaaaaaaaaaaaaaaaaaaaaaaaaa
aaaaaaaaaaaaaaaaaaaaaaaaaaaaaaaZaZabacalalalacawbpaUaKbqbrbsaKabaZaZaaaaaaaaaaaaaaaaaaaaaaaaaaaa
aaaaaaaaaaaaaaaaaaaaaaaaaaaaaaaZaZabakalalalaxawbpawaKaKapaKaKabaZaZaaaaaaaaaaaaaaaaaaaaaaaaaaaa
aaaaaaaaaaaaaaaaaaaaaaaaaaaaaaaZaZabacacacacbtbubvaWaYbabbacacabaZaZaaaaaaaaaaaaaaaaaaaaaaaaaaaa
aaaaaaaaaaaaaaaaaaaaaaaaayayayaZaZabacacacacacacacacacacasaoanabaZaZaaaaaaaaaaaaaaaaaaaaaaaaaaaa
aaaaaaaaaaaaaaaaaaaaaaaaazaAazaZaZabauacacacacacagacacacaiacacabaZaZaaaaaaaaaaaaaaaaaaaaaaaaaaaa
aaaaaaaaaaaaaaaaaaaaaaaaazaBazabababacacacacaIacacacacacaLaoaqabaZaZaaaaaaaaaaaaaaaaaaaaaaaaaaaa
aaaaaaaaaaaaaaaaaaaaaaaaaDaeaEaGaFaHacacacacacacacacacacaNacacabaZaZaaaaaaaaaaaaaaaaaaaaaaaaaaaa
aaaaaaaaaaaaaaaaaaaaaaaaayayayabababakacatatatacacacacacaiacaCabaZaZaaaaaaaaaaaaaaaaaaaaaaaaaaaa
aaaaaaaaaaaaaaaaaaaaaaaaaaaaaaaZaZabaOaPaRaRaRaPaPaPaPaPaTacacabaZaZaaaaaaaaaaaaaaaaaaaaaaaaaaaa
aaaaaaaaaaaaaaaaaaaaaaaaaaaaaaaZaZabaiacatatatacaQaVaSaXaMacacabaZaZaaaaaaaaaaaaaaaaaaaaaaaaaaaa
aaaaaaaaaaaaaaaaaaaaaaaaaaaaaaaZaZabajacacadacacacacacadacacacabaZaZaaaaaaaaaaaaaaaaaaaaaaaaaaaa
aaaaaaaaaaaaaaaaaaaaaaaaaaaaaaaZaZabababababababababababababababaZaZaaaaaaaaaaaaaaaaaaaaaaaaaaaa
aaaaaaaaaaaaaaaaaaaaaaaaaaaaaaaZaZaZaZaZaZaZaZaZaZaZaZaZaZaZaZaZaZaZaaaaaaaaaaaaaaaaaaaaaaaaaaaa
aaaaaaaaaaaaaaaaaaaaaaaaaaaaaaaZaZaZaZaZaZaZaZaZaZaZaZaZaZaZaZaZaZaZaaaaaaaaaaaaaaaaaaaaaaaaaaaa
aaaaaaaaaaaaaaaaaaaaaaaaaaaaaaaaaaaaaaaaaaaaaJaaaaaaaaaaaaaaaaaaaaaaaaaaaaaaaaaaaaaaaaaaaaaaaaaa
aaaaaaaaaaaaaaaaaaaaaaaaaaaaaaaaaaaaaaaaaaaaaaaaaaaaaaaaaaaaaaaaaaaaaaaaaaaaaaaaaaaaaaaaaaaaaaaa
aaaaaaaaaaaaaaaaaaaaaaaaaaaaaaaaaaaaaaaaaaaaaaaaaaaaaaaaaaaaaaaaaaaaaaaaaaaaaaaaaaaaaaaaaaaaaaaa
aaaaaaaaaaaaaaaaaaaaaaaaaaaaaaaaaaaaaaaaaaaaaaaaaaaaaaaaaaaaaaaaaaaaaaaaaaaaaaaaaaaaaaaaaaaaaaaa
aaaaaaaaaaaaaaaaaaaaaaaaaaaaaaaaaaaaaaaaaaaaaaaaaaaaaaaaaaaaaaaaaaaaaaaaaaaaaaaaaaaaaaaaaaaaaaaa
aaaaaaaaaaaaaaaaaaaaaaaaaaaaaaaaaaaaaaaaaaaaaaaaaaaaaaaaaaaaaaaaaaaaaaaaaaaaaaaaaaaaaaaaaaaaaaaa
"}
